* * * * * - - - - - - - - - - - - - - - - - - - * * * * * 
* * * * * - - - - - - - - - - - - - - - - - - b * * * * * 
* * * * * - * * * * * * * * * * * * * * * * * - * * * * * 
* * * * * * * * - - - - * * * * * - - - - * * * * * * * * 
* * * * * - * * - - - - * * * * * - - - - * * - * * * * * 
* * * * * - * * - - - - * * * * * - - - - * * - * * * * * 
* * * * * - * * * * * * - - b - - * * * * * * - * * * * *  
* * * * * - * * * * * * - * * * - * * * * * * - * * * * * 
@ - - - - y * * * * * * - * * * - * * * * * * y - - - - t 
* * * * * - * * * * * * - * * * - * * * * * * - * * * * * 
* * * * * - - - b - - - - * * * - - - - - - - - * * * * * 
* * * * * * * * * * * * * * * * * * * * * * * * * * * * * 
* * * * * * * * * * * * * * * * * * * * * * * * * * * * * 